1111111111111
101000000CC01
1000E01111111
1P0011E000101
1111111111111
